*** Все страницы для Пользователя

home - Страница общей  авторизации
form - Страница общей регистрации пользователя
prof - Страница профиля
txt - Страница тех.поддержки пользователя
homepage - Главная страница 
ctr - Страница описания ресторана 
ctrb - Страница описания блюда 
otv - Отзывы ресторана 
basket - Страница корзины 
zakp - заказы пользователя 
dbonuscart - Добавление бонусной карты 
bonuscarts - Бонусные карты 
samv -Страница самовывоза 
vvzal - Страница выноса в зал 
liker - Любимые рестораны 
dbankcart - Добавить банковскую карту
bonuscart - Бонусная карта 
carts - Карты 

*** Все страницы для Организации

dostuporg - Страница доступа организации 
glavnastr - Главная страница организации 
dannorg - Данные организации
filials - Филиалы 
dobavfil - Добавление филиала
registrsot - Регистрация сотрудника 
danvlad - Данные владельца 
menu - Меню ёпт)0)
opisblud - Описание блюд из меню
dobavblud - Добавление блюd

*** Все страницы для Сотрудника 

dostyp - Страница доступа сотрудника 
glavnaia - Главная страница
statistic - Страница статистики
detzak - Детали заказа 2! 
otvetotz - Ответ на отзыв
strazak - Страница заказов
historyzak - Страница истории 1!
historyzac - Страница истории 2!
detzac - Детали заказа 1!
arxivzak - Страница архива заказов
stoplist - Страница стоп листа
regimrab - Страница режима работы 
texpod - Тех.поддержка работника 1!
texpood - Тех.поддержка работника 2!


 
   



 